....................................................
............XXXXXXXXX.X..........................XXX
............XXX....XXXX..........................XXX
XXXX........XXX.X....XXXXXX................XXXXXXXXX
XXX.............X..XXXXXX..............XXXXXXXXXXX..
X...............XXXX........XX......................
........XXXX.......X..X...XXX...X...................
XXXXXXXXXXXXXXX....XXXX........X.X..............XXXX
XXXXXXX.........................X..............XXXXX
